6
*###########*
#           #
#           #
#      *    #
#           #
#           #
# @         #
#      $.   #
*###########*
